111111111111111111111111111111111
1              22               1
1  3           22         5     1
1              22               1
1    11111     22         2222221
1    1         22               1
1    1         22               1
1    11111     22               1
1              22        1      1
1              22        1      1
1              22        1      1
1       111111111111111111      1
1                               1
1                               1
1                               1
111111     11111       11111    1
111111     11111       11111    1
111111     11111       11111    1
111111     11111       11111    1
1                               1
1                               1
1                               1
1       111111111111111111      1
1       1      22               1
1       1      22               1
1       1      22               1
1              22     11111     1
1              22     1         1
122222         22     1         1
1              22     11111     1
1     5        22             4 1
1              22               1
111111111111111111111111111111111                                     

