1111111111111111111111111111111111111
1           1    22    22    1      1
1     3     1    22  5 22    1      1
1           1    22    22    1   5  1
1111    11111    22222222    1      1
1                22222222    1      1       
1                            1      1
1                            1      1
122221111111111      1111111112222221
1                             2222221
1                                   1
1                                   1
1                                   1
1     2222222222222222222222        1
1                                   1
1                                   1
1                                   1
1111111111111     1111111111111111111
1                                   1
1                                   1
1                                   1
1                            22222221
1111111111111111111     1111122222221
1                            22     1
1                            22  5  1
1                            22     1
11111111    1111111111111111111111111
1                                   1
1                                   1
1                                   1
122222222       1       1111    11111
122222222       1       1           1
1      22       1       1     4     1
1   5  22       1       1           1
1      22       1       1           1
1111111111111111111111111111111111111
